1111111111111111111111111111111
10P0000001000000000000000100001
1000000001000000N0000000000E001
100000000000000NCN0000000111111
100N0000N10000000N0000000000001
1000000001000000000000000000001
1000000C0000000C000000000000001
1111111111111111111111111111111
