NO ./path_to_the_north_texture

WE ./path_to_the_west_texture


SO ./path_to_the_south_texture


EA ./path_to_the_east_texture


F 220,100,0
C 205,30,0

111111
100001
1W001
10001
111111