11111111111
1P0000000E1
10110001101
1010C000101
10000100001
10001110001
10000100001
10100000101
1C110001101
1010C000101
10000100001
10001110001
10000100001
10100000101
1C110001101
1010C000101
10000100001
10001110001
10000100001
10100000101
1C110001101
1010C000101
10000100001
10001110001
10000100001
10100000101
1C110001101
1010C000101
10000100001
10001110001
10000100001
10100000101
1C110001101
1010C000101
10000100001
11111111111