1111111111111111111111111111111111111111111
10P0N0C00100000000010000010000C00NCN0000001
1000000001000000N001000C0101111101001EN0N01
100000000000000NCN0000111101NC0101101110111
100N0000N10000100N000000N001001101000100NC1
10000000010000CN000000000001000000010100001
10000000000N001000C0000N00C11111N001000N001
1111111111111111111111111111111111111111111
