1111111111111111111111111111111111
1E0000000000000C00000C0000000000F1
10100101001000001010010V0000010101
101001001010101001001000V000101001
1P0000000C00C0000000000000000000C1
1111111111111111111111111111111111
