11111111111111111111
100000000000C0000101
10000P000C00000010E1
100000000000000C1001
11111111111111111111
