11111111111111111111
100000000000C0000001
10000P000C00001110E1
100000000000001C1001
11111111111111111111
